WWWWWWWWWWWWWWWWWW
WHHHHHEEEEEEEEEEWW
WHHHHHEEBEBEEEEEWW
WHHHHHEEWEWWWWEEWW
WWWWWWEEWEEBEEWWWW
EWWWWWEEEEEEEEWWWW
EWEEEEEEWEEEEWWWWW
EWEWWWWWWEEEEWWWWW
EWEWEEBEEBBBEWWWWW
EWEWEWWEEWEBEWWWWW
EWEWEWEEBEEBBWWWWW
EWEEEBEEEEEBPWWWWW
EEEEEEEEEEEBBWWWWW
EEEEEEEEEEEEEWWWWW
WWWWWWWWWWEEEWWWWW