EEEEEEEEEEEEEEEEEE
EEWWWWWWWWWWWWWWWE
EEWWWWEEEEEWWWWWWE
EEWWWWEBBBEWWWWWWE
EEWWWEEEEBEWEEEEWE
EEWWEBEEEBEWEEEEWE
EEWEBPBEWEEWEEEEWE
EEWEHBHEWEEWEEEEWE
EEWEHHHEWWWWEEEEWE
EEWEHEHEEWEEEEEEWE
EEWEHEHEEWWWWWWWWE
EEWWWWWWWWEEEEEEEE
EEEEEEEEEEEEEEEEEE
EEEEEEEEEEEEEEEEEE
EEEEEEEEEEEEEEEEEE