EEEWWWWWWEEEEEEEEE
EEEWPEEEWWWEEEEEEE
EEWWBBBBEEWEEEEEEE
EWWHEEEEWBWWEEEEEE
EWEBWHBBWHEWWWEEEE
EWEEHHWHHBEHEWEEEE
EWWBWHEHHHBHWWEEEE
EWHEBHBWWBWWWEEEEW
EWEEEBEBEEWEEEEEEW
EWWWEEEEEWWEEEEEEW
EEEWWWWHWWEEEEEEEW
EEEEEEWWWEEEEEEWWW
EEEEEEEEEEEEEWWWWW
EEEEEEEEEEEWWWWWWW
EEEEEEEEEWWWWWWWWW