EEEEWWWEEEEEEEEEEW
EEEEEEBEWEEEEEEEEW
EEWEEEBEWEEEEEEEEW
EEWEWWEWWEEEEEEEWW
EEWEEWBWEEEEEEEEEW
EEEEEEHHHEEEEWPEEW
EEEWWEWWWWWWEWWWWE
WWEEEEHHHHEEEEEEWE
WEEWEEEEEEEEEWEEWE
WEEWWWWEWEWWEWEEWE
WEEWEEWEWEWEEWEEWE
WEEWEBEEBBBEEWEEWE
WEEWEWEEWEWEEWEEEE
WEEEEEEEWEEEEWEEEE
WWWWWWWWWWWWWWWWWW