EEEEEEWWWWWWWWWWWW
EEEEEEEBEEEEBEEEEW
EEEWWWWBWWEEWWWWEW
EEEEEEEEWEEEEWHHHW
EWEWWEEEWEEEEWHHHW
EWEWEEEEWEBWWWHHHW
EWEWWWWWWBEWWWHHHW
EWEWWWEEBEEWWWEEEW
EWBWPEEBBEEEBEEEEW
EEEWEEEEBWEBEEEEEW
EEEEEEEEEWWWEWWWEW
EEEWEEEEEEEWEEEWEW
EWEEEWEEEEEWEEEWEW
EWEEEEEWWEEWWWEEEW
WWEWEEEWEEEWWWWWWW